0%1%2%1%4%0%
3%2%2%1%4%1%
1%2%2%3%3%1%
2%3%3%1%1%2%
3%3%3%3%1%2%
!2%2%0%0%
